

             ███╗   ██╗███████╗██╗    ██╗             
             ████╗  ██║██╔════╝██║    ██║             
             ██╔██╗ ██║█████╗  ██║ █╗ ██║             
             ██║╚██╗██║██╔══╝  ██║███╗██║             
             ██║ ╚████║███████╗╚███╔███╔╝             
             ╚═╝  ╚═══╝╚══════╝ ╚══╝╚══╝              
                                                 
     ██╗     ███████╗██╗   ██╗███████╗██╗     ███████╗
     ██║     ██╔════╝██║   ██║██╔════╝██║     ██╔════╝
     ██║     █████╗  ██║   ██║█████╗  ██║     ███████╗
     ██║     ██╔══╝  ╚██╗ ██╔╝██╔══╝  ██║     ╚════██║
     ███████╗███████╗ ╚████╔╝ ███████╗███████╗███████║
     ╚══════╝╚══════╝  ╚═══╝  ╚══════╝╚══════╝╚══════╝
                                                 


